时	u
事	ui
室	ui
时	uio
十	uia
二十	erui
小时	xu
而是	eu

按	a
吧	b
此	c
打	d
嗯	e
发	f
管	g
化	h
见	j
块	k
立	l
嘛	m
哪	n
期	q
入	r
随	s
它	t
之	v
位	w
性	x
子	z
宝	bc
笨	bf
逼	bi
备	bw
猜	cd
达	da
道	dc
东	ds
逗	dz
份	ff
疯	fg
复	fu
搞	gc
钙	gd
哥	ge
官	gr
故	gu
华	hx
壶	hu
扯	ie
程	ig
臭	iz
今	jb
极	ji
贱	jm
居	ju
佳	jx
抠	kz
溜	lq
骂	ma
美	mw
浓	ns
弃	qi
缺	qt
惹	re
忍	rf
扔	rg
寺	si
淘	tc
替	ti
舔	tm
通	ts
退	tv
省	ug
守	uz
招	vc
症	vg
战	vj
终	vs
文	wf
忘	wh
玩	wj
未	ww
心	xb
型	xk
凶	xs
隐	yb
野	ye
杨	yh
严	yj
园	yr
友	yz
遭	zc
揍	zz
坐	zo
堆	dv
